level

++++++++.....................++++++++
++++++++                     ++++++++
++++++++                     ++++++++
++++++++ *  #      *       & ++++++++
##########  # ##@######   ###########
############  ####   *  ^^###########
#####################################
#####################################
#####################################
#####################################
#####################################
#####################################
#####################################


level

++++++++.....................++++++++
++++++++  -                  ++++++++
++++++++    -               -++++++++
++++++++ *  # -  $ *       & ++++++++
##########  # ##@######   ###########
############  ####   *  ^^###########
#####################################
#####################################
#####################################
#####################################
#####################################
#####################################
#####################################


