level

++++++++                                             ++++++++
++++++++ @                                        &  ++++++++
++++++++                    -  -  -               +  ++++++++
++++++++           *        $ *           *  *   +++$++++++++
##########  --#########-  #########   -######################
########### $*#########  -###       -  ######################
#######################-          -    ######################
#######################  -####  * $  ^^######################
#######################^^^####%%%%%%%%%######################
#######################%%%###################################
#############################################################
#############################################################
%%%%%%%%%%%%%%%%%%%%%%%%%%%%%%%%%%%%%%%%%%%%%%%%%%%%%%%%%%%%%


level

++++++++                                                                                           ++++++++
++++++++ @                                                                                    +    ++++++++
++++++++                                                               ^                     ++    ++++++++
++++++++                                                              %%%                   ++     ++++++++
##########      #######     ###                                      %%%%%                 ++$     ++++++++
########### *  -## * $   ^ ######                  *                %%%%%%%               +++++    ########
##################################-          - ##########^^#^^#^^#^^#######  % % % % %   ######    ########
################################## -       -   ######%%%%%%%%%%%%%%%%%%%###  # # # # # -#######    ########
##################################  -   -      ######%                 %###  # # # # #- $######    ########
##################################^^^-   * $ * ######% $ $ $ $ $ $ $ $ %###  # # # # #  #######^^&^########
#####################################################%%%%%%%%%%%%%%%%%%%###^^#^#^#^#^#^^###################
###########################################################################################################
###########################################################################################################
###########################################################################################################
%%%%%%%%%%%%%%%%%%%%%%%%%%%%%%%%%%%%%%%%%%%%%%%%%%%%%%%%%%%%%%%%%%%%%%%%%%%%%%%%%%%%%%%%%%%%%%%%%%%%%%%%%%%


level

++++++++       +++++++++++
++++++++ @     +++++++++++
++++++++       +++++++++++
++++++++       +++++++++++
#########      ###########
##########     $* ########
##########   -############
##########-  #############
########  *       ########
###############  #########
############### ##########
########### *$  ##########
##############  ##########
#########%    - ##########
#########       ##########
######### --- ############
######### ^^^^############
######### %%%%############
#########    #############
##########^ #   ##########
##########%   # & ########
###########%%%%%%%########
##########################
##########################
##########################
%%%%%%%%%%%%%%%%%%%%%%%%%%


level

++++++++       ####################################  ++++++++
++++++++ @                                        &  ++++++++
++++++++      ##            -  -  -               +  ++++++++
++++++++     #     *        $ *           *  *   +++$++++++++
##########  --#########-  #########   -######################
########### $*#########  -###       -  ######################
#######################-          -    ######################
#######################  -####  * $  ^^######################
#######################^^^####%%%%%%%%%######################
#######################%%%###################################
#############################################################
#############################################################
%%%%%%%%%%%%%%%%%%%%%%%%%%%%%%%%%%%%%%%%%%%%%%%%%%%%%%%%%%%%%

