level

^^^^^^^^.....................^
^^^^^^^^                     ^
^^^^^^^^                     ^
^^^^^^^^ *  #                ^
##########  # ##@#############
############  ####      * ####
##############################
##############################
##############################
##############################
##############################
##############################
##############################


level

..................
..................
..................


