level

++++++++.....................++++++++
++++++++                     ++++++++
++++++++                     ++++++++
++++++++ *  #      *       & ++++++++
##########  # ##@######   ###########
############  ####   *  ^^###########
#####################################
#####################################
#####################################
#####################################
#####################################
#####################################
#####################################


level

..................
..................
..................


